%%%%%%%%%
%   o   %
%    G  %
% o     %
%   .   %
%  o    %
%       %
%    P  %
%%%%%%%%%
