%%%%%%%%%
%      .%
%       %
% oooooo%
%       %
%       %
%ooooo% %
%       %
%P     G%
%%%%%%%%%
