%%%%%%%%%%%%%%%%%%%%%
%%%%%%.             %
%%%%%%% %           %
%%%%%%% %           %
%%%%%%% G           %
%%%%%%% %%%%        %
%%%%%%%    %        %
%%%%%%%%%% %        %
%%%%%%%%%%P%        %
%%%%%%%%%%%%%%%%%%%%%
